.............................
.                           .
.                           .
.     $                     .
.                           .
.                           .
.                           .
.                           .
.             +             .
.             +             .
.             +             .
.                           .
.                           .
.                           .
.                           .
.                           .
.                           .
.                           .
.                           .
.                           .
.                           .
.                           .
.                           .
.                           .
.                           .
.                           .
.                           .
.                           .
.............................